ABBV - AbbVie_Inc - Healthcare
ADM  - Archer_Daniels_Midland - Consumer Defensive
ALT  - Altria_Group - Consumer Defensive
ALV  - Allianz - Financial Services
BASF - BASF - Basic Materials
BKH  - Black_Hill_Corps - Utilities
BMY  - Bristol_Myers_Squibb - Healthcare
BNS  - Bank_of_Nova_Scotia - Financial Services
BNS2 - Bank_of_Nova_Scotia - Financial Services
CL   - Colgate_Palmolive - Consumer Defensive
CLX  - Clorox - Consumer Defensive
CSCO - Cisco - Technology
CVX  - Chevron_Corporation - Energy
D    - Dominion Energy - Utilities
DPW  - Deutsche_Post - Industrials
ED   - Consolidated_Edison - Utilities
EMR  - Emerson_Electric - Industrials
GAZ  - Gazprom - Energy
GIS  - General_Mills - none
GOV  - Govt_Properties_REIT - Real Estate
GPC  - Genuine_Parts_Company -  Consumer Cyclical
HAB  - Hamborner_REIT - Real Estate
PEAK - Healthpeak_Properties - Real Estate
INTC - Intel - Technology
JNJ  - Johnson_&_ Johnson - Healthcare
KMB  - Kimberly_Clark - Consumer Defensive
KO   - Coca_Cola_Co - Consumer Defensive
MCD  - McDonalds - Consumer Cyclical
MMM  - 3M - Industrials
MUV2 - Munich_Re - Financial Services
NFG  - National_Fuel_Gas_Company - Energy
O    - Realty_Income -  Real Estate
OHI  - Omega_Health_Care - Real Estate
ORI  - Old_Republic_International - Financial Services
PFE  - Pfizer - Healthcare
PG   - Procter_&_Gamble - Consumer Defensive
PM   - Philip_Morris - Consumer Defensive
QCOM - Qualcomm - Technology
QCP  - Quality_Care_Properties - none
T    - AT&T - Communication Services
TROW - T. Rowe Price Group - Financial Services
UL   - Unilever - Consumer Defensive
UPS  - United_Parcel_Service - Industrials
VZ   - Verizon_Communications - Communication Services
WBA  - Wallgreens_Boots_Alliance - Healthcare
WMT  - Wal_Mart_Stores - Consumer Defensive
WPC  - WP_Carey - Real Estate
XOM  - Exxon_Mobil - Energy
GD   - General_Dynamics_Corp.  - Industrials
CINF - Cincinnati_Financial_Corp. - Financial Services
LEG  - Legget_and_Platt - Consumer Cyclical
ADP  - Automatic_Data_Processing -  Industrials
NUC  - Nucor -  Basic Materials
ITW  - Illinois_Tool_Works - Industrials
TXN  - Texas_Instruments_Incorporated - Technology
LOW  - Lowe's_Companies_Inc - Consumer Cyclical
DBS  - DBS Bank Singapore - Financial Services
PEP  - PepsiCo - Consumer Defensive
UGI  - UGI Corporation - Utilities
JPM  - JPMorgan Chase - Financial Services
PNW  - Pinnacle West Capital Corporation - Utilities
DLR  - Digital Realty Trust - Real Estate
TMUS - T Mobile US Inc. - Communication Services
UKUD - iShares UK Dividend UCITS ETF - All
EMUD - iShares EM Dividend UCITS ETF - All
OKE - ONEOK - Energy
NGG - National Grid plc - Utilities
BAT - British American Tobacco plc - Consumer Defensive
BAE - BAE Systems plc - Industrials
BYR - Bayer AG - Healthcare
IBM - IBM - Technology
GILD - Gilead Sciences - Healthcare
STAG - STAG Industrial - Real Estate
AMGN - Amgen Inc. - Healthcare
PBA - Pembina Pipeline Corporation -  Energy
VIA - Viatris - Healthcare
ENB - Enbridge - Energy
AQN - Algonquin Power and Utilities Corp. - Utilities
TRP.TO - TC_Energy_Corp.  - Energy
EMA.TO - Emera_Inc. - Utilities
T.TO - TELUS_Corp. - Communication Services
MAIN - Main_Street_Capital_Corp. - Financial Services
HRL - Hormel_Foods_Corp. - Consumer Defensive
ZIM - Integrated_Shipping_Services - Industrials
RBC - Royal_Bank_of_Canada - Financial Services
CUD - Canadian_Utilities - Utilities
BBY - Best_Buy -  Consumer Cyclical
MANU - Manulife_Insurance -  Financial Services
CIBC - Canadian_Imperial_Bank_of_Commerce - Financial Services
POW.TO - Power_Corp_Canada - Financial Services
ARES - Ares Capital Corp. - Financial Services
MEDI - Medifast Inc. - Consumer Cyclical
ALLY - Ally Financial Inc. - Financial Services
TD - Toronto Dominion Bank - Financial Services
FORT - Fortis - Utilities
EIX  - Edison - Utilities
RIO - Rio Tinto - Basic Materials
K - Kellog - Consumer Defensive
CNR - Canadian Natural Resources Limited - Energy
MBG - Mercedes Benz Group AG - Consumer Cyclical
BMW - Bayerische Motoren Werke AG - Consumer Cyclical
BMW2 - Bayerische Motoren Werke AG - Consumer Cyclical
SSE - SSE Scotland - Utilities
APD - Air Products and Chemicals - Basic Materials
NEE - NextEra Energy - Utilities
WTRG - Essential Utilities - Utilities
LTC - LTC Properties - Real Estate
JGPI - JPM Global Equity Premium Income - All
QYLE - Global X Nasdaq 100 ESG Covered Call - All
